21111111111111111111111111111111111111111111111112
10000000000000000000000000000000000000000000000001
10000000000000000000000000000000000000000000000001
10000000000000000000000000000000000000000000000001
10000000000000000000000000000000000000000000000001
10000000000000000000000000000000000000000000000001
10000000001000000000000000000000000000010000000001
10000000001000000000000000000000000000010000000001
10000000001000000000000000000000000000010000000001
10000000001000000000000000000000000000010000000001
10000011111111100000000000000000000111111111000001
10000000001000000000000000000000000000010000000001
10000000001000000000000000000000000000010000000001
10000000001000000000000000000000000000010000000001
10000000001000000000000000000000000000010000000001
10000000000000000000000000000000000000000000000001
10000000000000000000000000000000000000000000000001
10000000000000000000000000000000000000000000000001
10000000000000000000000000000000000000000000000001
10000000000000000000000000000000000000000000000001
10000000000000000000000000000000000000000000000001
10000000000000000000000000000000000000000000000001
10000000000000000000000000000000000000000000000001
10000000000000000000000000000000000000000000000001
10000000000000000000000000000000000000000000000001
10000000000000000000000000000000000000000000000001
10000000000000000000000000000000000000000000000001
10000000000000000000000000000000000000000000000001
10000000000000000000000000000000000000000000000001
10000000000000000000000000000000000000000000000001
10000000000000000000000000000000000000000000000001
10000000000000000000000000000000000000000000000001
10000000000000000000000000000000000000000000000001
10000000000000000000000000000000000000000000000001
10000000000000000000000000000000000000000000000001
10000000001000000000000000000000000000010000000001
10000000001000000000000000000000000000010000000001
10000000001000000000000000000000000000010000000001
10000000001000000000000000000000000000010000000001
10000011111111100000000000000000000111111111000001
10000000001000000000000000000000000000010000000001
10000000001000000000000000000000000000010000000001
10000000001000000000000000000000000000010000000001
10000000001000000000000000000000000000010000000001
10000000000000000000000000000000000000000000000001
10000000000000000000000000000000000000000000000001
10000000000000000000000000000000000000000000000001
10000000000000000000000000000000000000000000000001
10000000000000000000000000000000000000000000000001
21111111111111111111111111111111111111111111111112